       addarf - Adds two or more Ancillary Response Files (ARFs) 
       addrmf - Adds together two or more RMFs
      brcaldb - Browse the Caldb data holdings
  c_caldbflag - switches flag status of calibration files in a CIF
  c_caldbinfo - Checks whether a local CALDB is correctly installed
                for a user
     c_crtcif - Create an empty Calibration Index File (CIF)
     calcrpsf - Calculates a radial point spread function
    caldbflag - switches flag status of calibration files in a CIF
    caldbinfo - Checks whether a local CALDB is correctly installed
       chkcif - Check entries in a Calibration Index File
      cifcadd - add a new column, CAL_ORIG, to a CIF
       cmppha - Converts a TYPE II to a TYPE I OGIP pha file
       cmprmf - Compress RMF by removing response below a threshold
      col2img - Converts a collimator response dataset to an image
        crcif - Creates an empty Calibration Index File
       dmprmf - Displays OGIP standard Response FITS file
      gcorpha - remaps PHA channels from SPECTRUM extension.
      gcorrmf - Remaps a detector redistribution matrix in channel-space
       genrsp - Generic spectral response generator
      lstgood - List "good" files found in a Calibration Index File
      marfrmf - Multiplies an ancillary response file by a redist matrix
      mkcaldb - Create a Calibration Database
     mkcaldir - Create the Caldb directory structure
    mkcalinit - Create a caldbinit file
       mudcif - Many UpDates to a Calibration Index File (CIF)
       quzcif - Interrogates Caldb for location of a dataset
       rbnrmf - Physically compresses a RMF file
      rbnrpsf - Rebins a radial point spread function
     rpsf2eef - Converts  a  radial  PSF  (RPSF)  dataset  to  a  radial
                encircled energy function (REEF) dataset.
      rpsfqdp - Converts OGIP format radial profile file to ASCII QDP
      rsp2rmf - Converts SF format response matrices to OGIP FITS format
      st2rpsf - Reads STWFITS file and writes an OGIP RPSF file
        stcal - Stores one or more calibration files in the Caldb
        udcif - Adds a calibration file to a CIF
